1231231231
2        2
2   22   2
3   3    1
3       31
1122     2
1        2
3  2   122
3  2     2
2211332211